NO ./sprites/NORTH.xpm
WE ./sprites/WEST.xpm
SO ./sprites/SOUTH.xpm
EA ./sprites/EAST.xpm

C 111,168,220
F 53,150,11

111111111111111111111
100000000000000000001
101110111101111011101
101000000000000000101
101000010000010000101
100000010000010000001
101000000000000000101
101011011101110110101
101000010000010000101
101000010000010000101
100000000010000000001
101000010000010000101
101000010000010000101
101011011101110110101
101000000000000000101
100000010000010000001
101000010000010000101
101000000000000000101
101110111101111011101
1000000000N0000000001
111111111111111111111
