NO ./sprites/NORTH.xpm
WE ./sprites/WEST.xpm
SO ./sprites/SOUTH.xpm
EA ./sprites/EAST.xpm

C 111,168,220
F 53,150,11

11111111111111111111111111111
10000000000000000000000000001
10001111111111111111111111111
10001
11011111111111111111111111111
11000010001000100010001000101
11011000100010001000100010001
10001111111111111111111111111
10001
10001
10001111111111111111111111111
100000000000000000000000000W1
11111111111111111111111111111